0000000000000000
0000000011110000
0000000110011100
0000000100000100
0000000100000111
0000000100000000
1111111100000000
0000000000000000