0000000000000
0000000011110
0000000110011
0000000100000
0000000100000
0000000100000
1111111100000
0000000000000