0000000000000
0000000000000
0000000111111
0000000100000
0000000100000
0000000100000
1111111100000
0000000000000