0111111111100
0100000000100
0100000000100
0100000000100
0100000111100
1100000100000
0000000100000
0000000111111