0011110000000
0010010000000
0010010000000
0010010000000
0010011110000
1110000010000
0000000010000
0000000011111