0000000000000
0000000000011
0000000000010
0000000000010
0000000000010
0000000000010
1111111111110
0000000000000