1100000000000
0110000000000
0011000000000
0001100000011
0000110000110
0000011001100
0000001101000
0000000111000